"filename", "language", "SourcePawn", "XML", "Valve CFG", "comment", "blank", "total"
"c:\Users\Mesha\Desktop\Ranks\addons\sourcemod\configs\rank_system.cfg", "Valve CFG", 0, 0, 156, 14, 14, 184
"c:\Users\Mesha\Desktop\Ranks\addons\sourcemod\scripting\awardpoints.sp", "SourcePawn", 72, 0, 0, 17, 12, 101
"c:\Users\Mesha\Desktop\Ranks\addons\sourcemod\scripting\commands.sp", "SourcePawn", 86, 0, 0, 17, 28, 131
"c:\Users\Mesha\Desktop\Ranks\addons\sourcemod\scripting\config.sp", "SourcePawn", 165, 0, 0, 25, 55, 245
"c:\Users\Mesha\Desktop\Ranks\addons\sourcemod\scripting\database.sp", "SourcePawn", 557, 0, 0, 22, 82, 661
"c:\Users\Mesha\Desktop\Ranks\addons\sourcemod\scripting\events.sp", "SourcePawn", 259, 0, 0, 20, 81, 360
"c:\Users\Mesha\Desktop\Ranks\addons\sourcemod\scripting\menu.sp", "SourcePawn", 42, 0, 0, 17, 15, 74
"c:\Users\Mesha\Desktop\Ranks\addons\sourcemod\scripting\points.sp", "SourcePawn", 126, 0, 0, 18, 47, 191
"c:\Users\Mesha\Desktop\Ranks\addons\sourcemod\scripting\rankdata.sp", "SourcePawn", 194, 0, 0, 33, 25, 252
"c:\Users\Mesha\Desktop\Ranks\addons\sourcemod\scripting\ranksystem_core.sp", "SourcePawn", 213, 0, 0, 17, 48, 278
"c:\Users\Mesha\Desktop\Ranks\addons\sourcemod\scripting\util.sp", "SourcePawn", 119, 0, 0, 29, 31, 179
"c:\Users\Mesha\Desktop\Ranks\materials\panorama\images\icons\skillgroups\skillgroup51.svg", "XML", 0, 144, 0, 1, 1, 146
"c:\Users\Mesha\Desktop\Ranks\materials\panorama\images\icons\skillgroups\skillgroup52.svg", "XML", 0, 145, 0, 1, 1, 147
"c:\Users\Mesha\Desktop\Ranks\materials\panorama\images\icons\skillgroups\skillgroup53.svg", "XML", 0, 166, 0, 1, 1, 168
"c:\Users\Mesha\Desktop\Ranks\materials\panorama\images\icons\skillgroups\skillgroup54.svg", "XML", 0, 342, 0, 1, 1, 344
"c:\Users\Mesha\Desktop\Ranks\materials\panorama\images\icons\skillgroups\skillgroup55.svg", "XML", 0, 301, 0, 1, 2, 304
"c:\Users\Mesha\Desktop\Ranks\materials\panorama\images\icons\skillgroups\skillgroup56.svg", "XML", 0, 418, 0, 1, 2, 421
"c:\Users\Mesha\Desktop\Ranks\materials\panorama\images\icons\skillgroups\skillgroup57.svg", "XML", 0, 2052, 0, 1, 123, 2176
"c:\Users\Mesha\Desktop\Ranks\materials\panorama\images\icons\skillgroups\skillgroup58.svg", "XML", 0, 1731, 0, 1, 124, 1856
"c:\Users\Mesha\Desktop\Ranks\materials\panorama\images\icons\skillgroups\skillgroup59.svg", "XML", 0, 1730, 0, 1, 125, 1856
"c:\Users\Mesha\Desktop\Ranks\materials\panorama\images\icons\skillgroups\skillgroup60.svg", "XML", 0, 1750, 0, 1, 126, 1877
"c:\Users\Mesha\Desktop\Ranks\materials\panorama\images\icons\skillgroups\skillgroup61.svg", "XML", 0, 778, 0, 1, 9, 788
"c:\Users\Mesha\Desktop\Ranks\materials\panorama\images\icons\skillgroups\skillgroup62.svg", "XML", 0, 2298, 0, 1, 130, 2429
"c:\Users\Mesha\Desktop\Ranks\materials\panorama\images\icons\skillgroups\skillgroup63.svg", "XML", 0, 1557, 0, 1, 85, 1643
"c:\Users\Mesha\Desktop\Ranks\materials\panorama\images\icons\skillgroups\skillgroup64.svg", "XML", 0, 215, 0, 1, 3, 219
"c:\Users\Mesha\Desktop\Ranks\materials\panorama\images\icons\skillgroups\skillgroup65.svg", "XML", 0, 1175, 0, 1, 15, 1191
"c:\Users\Mesha\Desktop\Ranks\materials\panorama\images\icons\skillgroups\skillgroup66.svg", "XML", 0, 2680, 0, 1, 136, 2817
"c:\Users\Mesha\Desktop\Ranks\materials\panorama\images\icons\skillgroups\skillgroup67.svg", "XML", 0, 2934, 0, 1, 9, 2944
"c:\Users\Mesha\Desktop\Ranks\materials\panorama\images\icons\skillgroups\skillgroup68.svg", "XML", 0, 6586, 0, 1, 360, 6947
"c:\Users\Mesha\Desktop\Ranks\materials\panorama\images\icons\skillgroups\skillgroup71.svg", "XML", 0, 199, 0, 1, 1, 201
"c:\Users\Mesha\Desktop\Ranks\materials\panorama\images\icons\skillgroups\skillgroup72.svg", "XML", 0, 176, 0, 1, 1, 178
"c:\Users\Mesha\Desktop\Ranks\materials\panorama\images\icons\skillgroups\skillgroup73.svg", "XML", 0, 196, 0, 1, 1, 198
"c:\Users\Mesha\Desktop\Ranks\materials\panorama\images\icons\skillgroups\skillgroup74.svg", "XML", 0, 315, 0, 1, 8, 324
"c:\Users\Mesha\Desktop\Ranks\materials\panorama\images\icons\skillgroups\skillgroup75.svg", "XML", 0, 226, 0, 1, 1, 228
"c:\Users\Mesha\Desktop\Ranks\materials\panorama\images\icons\skillgroups\skillgroup76.svg", "XML", 0, 329, 0, 1, 3, 333
"c:\Users\Mesha\Desktop\Ranks\materials\panorama\images\icons\skillgroups\skillgroup77.svg", "XML", 0, 350, 0, 1, 2, 353
"c:\Users\Mesha\Desktop\Ranks\materials\panorama\images\icons\skillgroups\skillgroup78.svg", "XML", 0, 264, 0, 1, 1, 266
"c:\Users\Mesha\Desktop\Ranks\materials\panorama\images\icons\skillgroups\skillgroup79.svg", "XML", 0, 300, 0, 1, 1, 302
"c:\Users\Mesha\Desktop\Ranks\materials\panorama\images\icons\skillgroups\skillgroup80.svg", "XML", 0, 341, 0, 1, 1, 343
"c:\Users\Mesha\Desktop\Ranks\materials\panorama\images\icons\skillgroups\skillgroup81.svg", "XML", 0, 348, 0, 1, 4, 353
"c:\Users\Mesha\Desktop\Ranks\materials\panorama\images\icons\skillgroups\skillgroup82.svg", "XML", 0, 278, 0, 1, 1, 280
"c:\Users\Mesha\Desktop\Ranks\materials\panorama\images\icons\skillgroups\skillgroup83.svg", "XML", 0, 1363, 0, 1, 73, 1437
"c:\Users\Mesha\Desktop\Ranks\materials\panorama\images\icons\skillgroups\skillgroup84.svg", "XML", 0, 1616, 0, 1, 16, 1633
"c:\Users\Mesha\Desktop\Ranks\materials\panorama\images\icons\skillgroups\skillgroup85.svg", "XML", 0, 1378, 0, 1, 22, 1401
"Total", "-", 1833, 34681, 156, 262, 1827, 38759